########################### ######################
########################### ######################
########################### ######################
######                                        ####
######  ##########################################
######  ##########################################
######                                    ########
##################  ####################  ########
##################  ####################  ########
########################################  ########
######                                    ####  ##
######  ######################################  ##
######  ######################################  ##
######                                          ##
######  ####################  ####################
######  ####################  ####################
######  ####################  ####################
######  ####################  ####################
######  ####################                 #####
######  ##########################################